   0   1   2   3   4   5   4   3   2   1
   1  -1  -1   4   5   6   5   4   3   2
   2  -1  -1   5   6   7   6   5   4   3
   3  -1  -1   6   7   8   7   6   5   4
   4  -1  -1   7   8   9   8   7   6   5
   5  -1  -1   8   9  10   9   8   7   6
   4  -1  -1   7   8   9   8   7   6   5
   3  -1  -1   6   7   8   7   6   5   4
   2  -1  -1   5   6   7   6   5   4   3
   1   2   3   4   5   6   5   4   3   2
